WWWWWWWWWWWWWWWWWWWWW
W S W D       D     W
W   WWW             W
W     D    D        W
W               R   W
WWWWWWWWWWWWWWWWWWWWW