WWWWWWWWWWWWWWWWWWWWWWWWWWWWWWWWWWWWWWWWWW
W                D  WWWWWWWWWWWWWWWWWWWWWW
W D                 WWWWWWWWWWWWWWWWWWWWWW
W                   WWWWWWWWWWWWWWWWWWWWWW
W  D            D   WWWWWWWWWWWWWWWWWWWWWW
W                     D         WWWWWWWWWW
W R    D                        WWWWWWWWWW
WWWWWWWWWWWWWWWWWWWWWWW                S W
WWWWWWWWWWWWWWWWWWWWWWWD      D        D W
WWWWWWWWWWWWWWWWWWWWWWWWWWWWWWWWWWWWWWWWWW