WWWWWWWWWWWWWWWWWWWWW
W S W R          D  W
W D WWWWWWWWWWW  WWWW
W       D D         W
W  D            D   W
WWWWWWWWWWWWWWWWWWWWW